000000000000000
0*           10
0 00000000000 0
0 0         0 0
0 0         0 0
0 0         0 0
0 00000000000 0
01           10
000000000000000